"filename", "language", "C++", "comment", "blank", "total"
"/Users/danieldew/Documents/GitHub/29457A-Worlds/Code/Worlds-MAIN/src/Inputs.cpp", "C++", 71, 0, 11, 82
"/Users/danieldew/Documents/GitHub/29457A-Worlds/Code/Worlds-MAIN/src/autonomous.cpp", "C++", 44, 1, 5, 50
"/Users/danieldew/Documents/GitHub/29457A-Worlds/Code/Worlds-MAIN/src/main.cpp", "C++", 32, 52, 10, 94
"/Users/danieldew/Documents/GitHub/29457A-Worlds/Code/Worlds-MAIN/src/opcontrol.cpp", "C++", 99, 0, 16, 115
"/Users/danieldew/Documents/GitHub/29457A-Worlds/Code/Worlds-MAIN/src/robotConfig/dimensions.cpp", "C++", 7, 0, 1, 8
"/Users/danieldew/Documents/GitHub/29457A-Worlds/Code/Worlds-MAIN/src/robotConfig/motors.cpp", "C++", 20, 1, 5, 26
"/Users/danieldew/Documents/GitHub/29457A-Worlds/Code/Worlds-MAIN/src/robotConfig/pistons.cpp", "C++", 5, 0, 1, 6
"/Users/danieldew/Documents/GitHub/29457A-Worlds/Code/Worlds-MAIN/src/robotConfig/robot.cpp", "C++", 8, 0, 2, 10
"/Users/danieldew/Documents/GitHub/29457A-Worlds/Code/Worlds-MAIN/src/robotConfig/sensors.cpp", "C++", 10, 0, 2, 12
"/Users/danieldew/Documents/GitHub/29457A-Worlds/Code/Worlds-MAIN/src/robotConfig/tunables.cpp", "C++", 24, 0, 1, 25
"/Users/danieldew/Documents/GitHub/29457A-Worlds/Code/Worlds-MAIN/src/subsystems/BalanceMech.cpp", "C++", 10, 0, 2, 12
"/Users/danieldew/Documents/GitHub/29457A-Worlds/Code/Worlds-MAIN/src/subsystems/Intake.cpp", "C++", 55, 0, 3, 58
"/Users/danieldew/Documents/GitHub/29457A-Worlds/Code/Worlds-MAIN/src/subsystems/catapult.cpp", "C++", 53, 0, 5, 58
"/Users/danieldew/Documents/GitHub/29457A-Worlds/Code/Worlds-MAIN/src/subsystems/wings.cpp", "C++", 28, 0, 1, 29
"/Users/danieldew/Documents/GitHub/29457A-Worlds/Code/Worlds-MAIN/src/utils.cpp", "C++", 63, 0, 3, 66
"Total", "-", 529, 54, 68, 651