"filename", "language", "C++", "Makefile", "Markdown", "comment", "blank", "total"
"/Users/danieldew/Documents/GitHub/29457A-Worlds/Code/Worlds-MAIN/include/api.h", "C++", -57, 0, 0, -17, -7, -81
"/Users/danieldew/Documents/GitHub/29457A-Worlds/Code/Worlds-MAIN/include/display/README.md", "Markdown", 0, 0, -58, 0, -14, -72
"/Users/danieldew/Documents/GitHub/29457A-Worlds/Code/Worlds-MAIN/include/display/lv_conf.h", "C++", -184, 0, 0, -95, -63, -342
"/Users/danieldew/Documents/GitHub/29457A-Worlds/Code/Worlds-MAIN/include/display/lv_conf_checker.h", "C++", -450, 0, 0, -136, -79, -665
"/Users/danieldew/Documents/GitHub/29457A-Worlds/Code/Worlds-MAIN/include/display/lv_core/lv_core.mk", "Makefile", 0, -10, 0, 0, -3, -13
"/Users/danieldew/Documents/GitHub/29457A-Worlds/Code/Worlds-MAIN/include/display/lv_core/lv_group.h", "C++", -72, 0, 0, -137, -39, -248
"/Users/danieldew/Documents/GitHub/29457A-Worlds/Code/Worlds-MAIN/include/display/lv_core/lv_indev.h", "C++", -31, 0, 0, -99, -28, -158
"/Users/danieldew/Documents/GitHub/29457A-Worlds/Code/Worlds-MAIN/include/display/lv_core/lv_lang.h", "C++", -22, 0, 0, -36, -17, -75
"/Users/danieldew/Documents/GitHub/29457A-Worlds/Code/Worlds-MAIN/include/display/lv_core/lv_obj.h", "C++", -258, 0, 0, -449, -135, -842
"/Users/danieldew/Documents/GitHub/29457A-Worlds/Code/Worlds-MAIN/include/display/lv_core/lv_refr.h", "C++", -18, 0, 0, -58, -20, -96
"/Users/danieldew/Documents/GitHub/29457A-Worlds/Code/Worlds-MAIN/include/display/lv_core/lv_style.h", "C++", -110, 0, 0, -58, -32, -200
"/Users/danieldew/Documents/GitHub/29457A-Worlds/Code/Worlds-MAIN/include/display/lv_core/lv_vdb.h", "C++", -40, 0, 0, -53, -27, -120
"/Users/danieldew/Documents/GitHub/29457A-Worlds/Code/Worlds-MAIN/include/display/lv_draw/lv_draw.h", "C++", -46, 0, 0, -51, -19, -116
"/Users/danieldew/Documents/GitHub/29457A-Worlds/Code/Worlds-MAIN/include/display/lv_draw/lv_draw.mk", "Makefile", 0, -12, 0, 0, -3, -15
"/Users/danieldew/Documents/GitHub/29457A-Worlds/Code/Worlds-MAIN/include/display/lv_draw/lv_draw_arc.h", "C++", -12, 0, 0, -30, -12, -54
"/Users/danieldew/Documents/GitHub/29457A-Worlds/Code/Worlds-MAIN/include/display/lv_draw/lv_draw_img.h", "C++", -57, 0, 0, -75, -36, -168
"/Users/danieldew/Documents/GitHub/29457A-Worlds/Code/Worlds-MAIN/include/display/lv_draw/lv_draw_label.h", "C++", -12, 0, 0, -30, -12, -54
"/Users/danieldew/Documents/GitHub/29457A-Worlds/Code/Worlds-MAIN/include/display/lv_draw/lv_draw_line.h", "C++", -11, 0, 0, -27, -12, -50
"/Users/danieldew/Documents/GitHub/29457A-Worlds/Code/Worlds-MAIN/include/display/lv_draw/lv_draw_rbasic.h", "C++", -29, 0, 0, -50, -18, -97
"/Users/danieldew/Documents/GitHub/29457A-Worlds/Code/Worlds-MAIN/include/display/lv_draw/lv_draw_rect.h", "C++", -11, 0, 0, -26, -12, -49
"/Users/danieldew/Documents/GitHub/29457A-Worlds/Code/Worlds-MAIN/include/display/lv_draw/lv_draw_triangle.h", "C++", -14, 0, 0, -26, -12, -52
"/Users/danieldew/Documents/GitHub/29457A-Worlds/Code/Worlds-MAIN/include/display/lv_draw/lv_draw_vbasic.h", "C++", -28, 0, 0, -46, -16, -90
"/Users/danieldew/Documents/GitHub/29457A-Worlds/Code/Worlds-MAIN/include/display/lv_fonts/lv_font_builtin.h", "C++", -91, 0, 0, -29, -31, -151
"/Users/danieldew/Documents/GitHub/29457A-Worlds/Code/Worlds-MAIN/include/display/lv_fonts/lv_fonts.mk", "Makefile", 0, -21, 0, 0, -3, -24
"/Users/danieldew/Documents/GitHub/29457A-Worlds/Code/Worlds-MAIN/include/display/lv_hal/lv_hal.h", "C++", -12, 0, 0, -19, -10, -41
"/Users/danieldew/Documents/GitHub/29457A-Worlds/Code/Worlds-MAIN/include/display/lv_hal/lv_hal.mk", "Makefile", 0, -6, 0, 0, -3, -9
"/Users/danieldew/Documents/GitHub/29457A-Worlds/Code/Worlds-MAIN/include/display/lv_hal/lv_hal_disp.h", "C++", -44, 0, 0, -104, -27, -175
"/Users/danieldew/Documents/GitHub/29457A-Worlds/Code/Worlds-MAIN/include/display/lv_hal/lv_hal_indev.h", "C++", -88, 0, 0, -51, -28, -167
"/Users/danieldew/Documents/GitHub/29457A-Worlds/Code/Worlds-MAIN/include/display/lv_hal/lv_hal_tick.h", "C++", -22, 0, 0, -32, -13, -67
"/Users/danieldew/Documents/GitHub/29457A-Worlds/Code/Worlds-MAIN/include/display/lv_misc/lv_anim.h", "C++", -51, 0, 0, -97, -30, -178
"/Users/danieldew/Documents/GitHub/29457A-Worlds/Code/Worlds-MAIN/include/display/lv_misc/lv_area.h", "C++", -49, 0, 0, -94, -27, -170
"/Users/danieldew/Documents/GitHub/29457A-Worlds/Code/Worlds-MAIN/include/display/lv_misc/lv_circ.h", "C++", -30, 0, 0, -35, -15, -80
"/Users/danieldew/Documents/GitHub/29457A-Worlds/Code/Worlds-MAIN/include/display/lv_misc/lv_color.h", "C++", -344, 0, 0, -58, -44, -446
"/Users/danieldew/Documents/GitHub/29457A-Worlds/Code/Worlds-MAIN/include/display/lv_misc/lv_font.h", "C++", -64, 0, 0, -95, -34, -193
"/Users/danieldew/Documents/GitHub/29457A-Worlds/Code/Worlds-MAIN/include/display/lv_misc/lv_fs.h", "C++", -96, 0, 0, -140, -42, -278
"/Users/danieldew/Documents/GitHub/29457A-Worlds/Code/Worlds-MAIN/include/display/lv_misc/lv_gc.h", "C++", -41, 0, 0, -19, -18, -78
"/Users/danieldew/Documents/GitHub/29457A-Worlds/Code/Worlds-MAIN/include/display/lv_misc/lv_ll.h", "C++", -33, 0, 0, -86, -27, -146
"/Users/danieldew/Documents/GitHub/29457A-Worlds/Code/Worlds-MAIN/include/display/lv_misc/lv_log.h", "C++", -35, 0, 0, -33, -19, -87
"/Users/danieldew/Documents/GitHub/29457A-Worlds/Code/Worlds-MAIN/include/display/lv_misc/lv_math.h", "C++", -20, 0, 0, -39, -15, -74
"/Users/danieldew/Documents/GitHub/29457A-Worlds/Code/Worlds-MAIN/include/display/lv_misc/lv_mem.h", "C++", -47, 0, 0, -57, -24, -128
"/Users/danieldew/Documents/GitHub/29457A-Worlds/Code/Worlds-MAIN/include/display/lv_misc/lv_misc.mk", "Makefile", 0, -17, 0, 0, -3, -20
"/Users/danieldew/Documents/GitHub/29457A-Worlds/Code/Worlds-MAIN/include/display/lv_misc/lv_symbol_def.h", "C++", -187, 0, 0, -9, -12, -208
"/Users/danieldew/Documents/GitHub/29457A-Worlds/Code/Worlds-MAIN/include/display/lv_misc/lv_task.h", "C++", -52, 0, 0, -75, -23, -150
"/Users/danieldew/Documents/GitHub/29457A-Worlds/Code/Worlds-MAIN/include/display/lv_misc/lv_templ.h", "C++", -9, 0, 0, -19, -11, -39
"/Users/danieldew/Documents/GitHub/29457A-Worlds/Code/Worlds-MAIN/include/display/lv_misc/lv_txt.h", "C++", -52, 0, 0, -118, -29, -199
"/Users/danieldew/Documents/GitHub/29457A-Worlds/Code/Worlds-MAIN/include/display/lv_misc/lv_ufs.h", "C++", -55, 0, 0, -128, -32, -215
"/Users/danieldew/Documents/GitHub/29457A-Worlds/Code/Worlds-MAIN/include/display/lv_objx/lv_arc.h", "C++", -31, 0, 0, -68, -29, -128
"/Users/danieldew/Documents/GitHub/29457A-Worlds/Code/Worlds-MAIN/include/display/lv_objx/lv_bar.h", "C++", -45, 0, 0, -87, -29, -161
"/Users/danieldew/Documents/GitHub/29457A-Worlds/Code/Worlds-MAIN/include/display/lv_objx/lv_btn.h", "C++", -98, 0, 0, -140, -42, -280
"/Users/danieldew/Documents/GitHub/29457A-Worlds/Code/Worlds-MAIN/include/display/lv_objx/lv_btnm.h", "C++", -61, 0, 0, -104, -33, -198
"/Users/danieldew/Documents/GitHub/29457A-Worlds/Code/Worlds-MAIN/include/display/lv_objx/lv_calendar.h", "C++", -78, 0, 0, -126, -43, -247
"/Users/danieldew/Documents/GitHub/29457A-Worlds/Code/Worlds-MAIN/include/display/lv_objx/lv_canvas.h", "C++", -42, 0, 0, -154, -34, -230
"/Users/danieldew/Documents/GitHub/29457A-Worlds/Code/Worlds-MAIN/include/display/lv_objx/lv_cb.h", "C++", -65, 0, 0, -79, -31, -175
"/Users/danieldew/Documents/GitHub/29457A-Worlds/Code/Worlds-MAIN/include/display/lv_objx/lv_chart.h", "C++", -77, 0, 0, -145, -41, -263
"/Users/danieldew/Documents/GitHub/29457A-Worlds/Code/Worlds-MAIN/include/display/lv_objx/lv_cont.h", "C++", -54, 0, 0, -80, -30, -164
"/Users/danieldew/Documents/GitHub/29457A-Worlds/Code/Worlds-MAIN/include/display/lv_objx/lv_ddlist.h", "C++", -74, 0, 0, -149, -43, -266
"/Users/danieldew/Documents/GitHub/29457A-Worlds/Code/Worlds-MAIN/include/display/lv_objx/lv_gauge.h", "C++", -74, 0, 0, -116, -33, -223
"/Users/danieldew/Documents/GitHub/29457A-Worlds/Code/Worlds-MAIN/include/display/lv_objx/lv_img.h", "C++", -70, 0, 0, -96, -30, -196
"/Users/danieldew/Documents/GitHub/29457A-Worlds/Code/Worlds-MAIN/include/display/lv_objx/lv_imgbtn.h", "C++", -84, 0, 0, -125, -40, -249
"/Users/danieldew/Documents/GitHub/29457A-Worlds/Code/Worlds-MAIN/include/display/lv_objx/lv_kb.h", "C++", -63, 0, 0, -102, -35, -200
"/Users/danieldew/Documents/GitHub/29457A-Worlds/Code/Worlds-MAIN/include/display/lv_objx/lv_label.h", "C++", -93, 0, 0, -160, -43, -296
"/Users/danieldew/Documents/GitHub/29457A-Worlds/Code/Worlds-MAIN/include/display/lv_objx/lv_led.h", "C++", -35, 0, 0, -60, -22, -117
"/Users/danieldew/Documents/GitHub/29457A-Worlds/Code/Worlds-MAIN/include/display/lv_objx/lv_line.h", "C++", -50, 0, 0, -81, -28, -159
"/Users/danieldew/Documents/GitHub/29457A-Worlds/Code/Worlds-MAIN/include/display/lv_objx/lv_list.h", "C++", -105, 0, 0, -180, -52, -337
"/Users/danieldew/Documents/GitHub/29457A-Worlds/Code/Worlds-MAIN/include/display/lv_objx/lv_lmeter.h", "C++", -43, 0, 0, -85, -26, -154
"/Users/danieldew/Documents/GitHub/29457A-Worlds/Code/Worlds-MAIN/include/display/lv_objx/lv_mbox.h", "C++", -60, 0, 0, -106, -38, -204
"/Users/danieldew/Documents/GitHub/29457A-Worlds/Code/Worlds-MAIN/include/display/lv_objx/lv_objx.mk", "Makefile", 0, -34, 0, 0, -3, -37
"/Users/danieldew/Documents/GitHub/29457A-Worlds/Code/Worlds-MAIN/include/display/lv_objx/lv_objx_templ.h", "C++", -28, 0, 0, -58, -26, -112
"/Users/danieldew/Documents/GitHub/29457A-Worlds/Code/Worlds-MAIN/include/display/lv_objx/lv_page.h", "C++", -125, 0, 0, -203, -55, -383
"/Users/danieldew/Documents/GitHub/29457A-Worlds/Code/Worlds-MAIN/include/display/lv_objx/lv_preload.h", "C++", -49, 0, 0, -87, -33, -169
"/Users/danieldew/Documents/GitHub/29457A-Worlds/Code/Worlds-MAIN/include/display/lv_objx/lv_roller.h", "C++", -74, 0, 0, -117, -34, -225
"/Users/danieldew/Documents/GitHub/29457A-Worlds/Code/Worlds-MAIN/include/display/lv_objx/lv_slider.h", "C++", -65, 0, 0, -106, -32, -203
"/Users/danieldew/Documents/GitHub/29457A-Worlds/Code/Worlds-MAIN/include/display/lv_objx/lv_spinbox.h", "C++", -60, 0, 0, -104, -38, -202
"/Users/danieldew/Documents/GitHub/29457A-Worlds/Code/Worlds-MAIN/include/display/lv_objx/lv_sw.h", "C++", -66, 0, 0, -98, -31, -195
"/Users/danieldew/Documents/GitHub/29457A-Worlds/Code/Worlds-MAIN/include/display/lv_objx/lv_ta.h", "C++", -119, 0, 0, -213, -59, -391
"/Users/danieldew/Documents/GitHub/29457A-Worlds/Code/Worlds-MAIN/include/display/lv_objx/lv_table.h", "C++", -68, 0, 0, -152, -42, -262
"/Users/danieldew/Documents/GitHub/29457A-Worlds/Code/Worlds-MAIN/include/display/lv_objx/lv_tabview.h", "C++", -77, 0, 0, -134, -42, -253
"/Users/danieldew/Documents/GitHub/29457A-Worlds/Code/Worlds-MAIN/include/display/lv_objx/lv_tileview.h", "C++", -49, 0, 0, -81, -34, -164
"/Users/danieldew/Documents/GitHub/29457A-Worlds/Code/Worlds-MAIN/include/display/lv_objx/lv_win.h", "C++", -87, 0, 0, -151, -45, -283
"/Users/danieldew/Documents/GitHub/29457A-Worlds/Code/Worlds-MAIN/include/display/lv_themes/lv_theme.h", "C++", -255, 0, 0, -31, -47, -333
"/Users/danieldew/Documents/GitHub/29457A-Worlds/Code/Worlds-MAIN/include/display/lv_themes/lv_theme_alien.h", "C++", -18, 0, 0, -29, -13, -60
"/Users/danieldew/Documents/GitHub/29457A-Worlds/Code/Worlds-MAIN/include/display/lv_themes/lv_theme_default.h", "C++", -18, 0, 0, -29, -14, -61
"/Users/danieldew/Documents/GitHub/29457A-Worlds/Code/Worlds-MAIN/include/display/lv_themes/lv_theme_material.h", "C++", -18, 0, 0, -29, -14, -61
"/Users/danieldew/Documents/GitHub/29457A-Worlds/Code/Worlds-MAIN/include/display/lv_themes/lv_theme_mono.h", "C++", -18, 0, 0, -29, -14, -61
"/Users/danieldew/Documents/GitHub/29457A-Worlds/Code/Worlds-MAIN/include/display/lv_themes/lv_theme_nemo.h", "C++", -18, 0, 0, -29, -14, -61
"/Users/danieldew/Documents/GitHub/29457A-Worlds/Code/Worlds-MAIN/include/display/lv_themes/lv_theme_night.h", "C++", -18, 0, 0, -29, -14, -61
"/Users/danieldew/Documents/GitHub/29457A-Worlds/Code/Worlds-MAIN/include/display/lv_themes/lv_theme_templ.h", "C++", -18, 0, 0, -29, -14, -61
"/Users/danieldew/Documents/GitHub/29457A-Worlds/Code/Worlds-MAIN/include/display/lv_themes/lv_theme_zen.h", "C++", -18, 0, 0, -29, -14, -61
"/Users/danieldew/Documents/GitHub/29457A-Worlds/Code/Worlds-MAIN/include/display/lv_themes/lv_themes.mk", "Makefile", 0, -12, 0, 0, -3, -15
"/Users/danieldew/Documents/GitHub/29457A-Worlds/Code/Worlds-MAIN/include/display/lv_version.h", "C++", -14, 0, 0, -41, -12, -67
"/Users/danieldew/Documents/GitHub/29457A-Worlds/Code/Worlds-MAIN/include/display/lvgl.h", "C++", -54, 0, 0, -19, -16, -89
"/Users/danieldew/Documents/GitHub/29457A-Worlds/Code/Worlds-MAIN/include/fmt/args.h", "C++", -108, 0, 0, -67, -33, -208
"/Users/danieldew/Documents/GitHub/29457A-Worlds/Code/Worlds-MAIN/include/fmt/core.h", "C++", -1847, 0, 0, -339, -481, -2667
"/Users/danieldew/Documents/GitHub/29457A-Worlds/Code/Worlds-MAIN/include/fmt/format-inl.h", "C++", -1300, 0, 0, -109, -130, -1539
"/Users/danieldew/Documents/GitHub/29457A-Worlds/Code/Worlds-MAIN/include/fmt/format.h", "C++", -3054, 0, 0, -533, -527, -4114
"/Users/danieldew/Documents/GitHub/29457A-Worlds/Code/Worlds-MAIN/include/lemlib/api.hpp", "C++", -7, 0, 0, 0, -1, -8
"/Users/danieldew/Documents/GitHub/29457A-Worlds/Code/Worlds-MAIN/include/lemlib/asset.hpp", "C++", -14, 0, 0, 0, -5, -19
"/Users/danieldew/Documents/GitHub/29457A-Worlds/Code/Worlds-MAIN/include/lemlib/chassis/chassis.hpp", "C++", -120, 0, 0, -295, -15, -430
"/Users/danieldew/Documents/GitHub/29457A-Worlds/Code/Worlds-MAIN/include/lemlib/chassis/odom.hpp", "C++", -13, 0, 0, -45, -3, -61
"/Users/danieldew/Documents/GitHub/29457A-Worlds/Code/Worlds-MAIN/include/lemlib/chassis/trackingWheel.hpp", "C++", -38, 0, 0, -46, -4, -88
"/Users/danieldew/Documents/GitHub/29457A-Worlds/Code/Worlds-MAIN/include/lemlib/exitcondition.hpp", "C++", -15, 0, 0, -23, -4, -42
"/Users/danieldew/Documents/GitHub/29457A-Worlds/Code/Worlds-MAIN/include/lemlib/logger/baseSink.hpp", "C++", -54, 0, 0, -134, -22, -210
"/Users/danieldew/Documents/GitHub/29457A-Worlds/Code/Worlds-MAIN/include/lemlib/logger/buffer.hpp", "C++", -24, 0, 0, -36, -13, -73
"/Users/danieldew/Documents/GitHub/29457A-Worlds/Code/Worlds-MAIN/include/lemlib/logger/infoSink.hpp", "C++", -13, 0, 0, -23, -4, -40
"/Users/danieldew/Documents/GitHub/29457A-Worlds/Code/Worlds-MAIN/include/lemlib/logger/logger.hpp", "C++", -12, 0, 0, -8, -7, -27
"/Users/danieldew/Documents/GitHub/29457A-Worlds/Code/Worlds-MAIN/include/lemlib/logger/message.hpp", "C++", -11, 0, 0, -17, -7, -35
"/Users/danieldew/Documents/GitHub/29457A-Worlds/Code/Worlds-MAIN/include/lemlib/logger/stdout.hpp", "C++", -14, 0, 0, -15, -6, -35
"/Users/danieldew/Documents/GitHub/29457A-Worlds/Code/Worlds-MAIN/include/lemlib/logger/telemetrySink.hpp", "C++", -10, 0, 0, -22, -3, -35
"/Users/danieldew/Documents/GitHub/29457A-Worlds/Code/Worlds-MAIN/include/lemlib/pid.hpp", "C++", -17, 0, 0, -21, -5, -43
"/Users/danieldew/Documents/GitHub/29457A-Worlds/Code/Worlds-MAIN/include/lemlib/pose.hpp", "C++", -21, 0, 0, -71, -4, -96
"/Users/danieldew/Documents/GitHub/29457A-Worlds/Code/Worlds-MAIN/include/lemlib/timer.hpp", "C++", -22, 0, 0, -47, -2, -71
"/Users/danieldew/Documents/GitHub/29457A-Worlds/Code/Worlds-MAIN/include/lemlib/util.hpp", "C++", -14, 0, 0, -61, -9, -84
"/Users/danieldew/Documents/GitHub/29457A-Worlds/Code/Worlds-MAIN/include/main.h", "C++", -19, 0, 0, -53, -10, -82
"/Users/danieldew/Documents/GitHub/29457A-Worlds/Code/Worlds-MAIN/include/okapi/api.hpp", "C++", -92, 0, 0, -34, -9, -135
"/Users/danieldew/Documents/GitHub/29457A-Worlds/Code/Worlds-MAIN/include/okapi/api/chassis/controller/chassisController.hpp", "C++", -33, 0, 0, -88, -22, -143
"/Users/danieldew/Documents/GitHub/29457A-Worlds/Code/Worlds-MAIN/include/okapi/api/chassis/controller/chassisControllerIntegrated.hpp", "C++", -46, 0, 0, -117, -22, -185
"/Users/danieldew/Documents/GitHub/29457A-Worlds/Code/Worlds-MAIN/include/okapi/api/chassis/controller/chassisControllerPid.hpp", "C++", -80, 0, 0, -161, -35, -276
"/Users/danieldew/Documents/GitHub/29457A-Worlds/Code/Worlds-MAIN/include/okapi/api/chassis/controller/chassisScales.hpp", "C++", -29, 0, 0, -54, -6, -89
"/Users/danieldew/Documents/GitHub/29457A-Worlds/Code/Worlds-MAIN/include/okapi/api/chassis/controller/defaultOdomChassisController.hpp", "C++", -51, 0, 0, -104, -29, -184
"/Users/danieldew/Documents/GitHub/29457A-Worlds/Code/Worlds-MAIN/include/okapi/api/chassis/controller/odomChassisController.hpp", "C++", -55, 0, 0, -80, -20, -155
"/Users/danieldew/Documents/GitHub/29457A-Worlds/Code/Worlds-MAIN/include/okapi/api/chassis/model/chassisModel.hpp", "C++", -33, 0, 0, -112, -21, -166
"/Users/danieldew/Documents/GitHub/29457A-Worlds/Code/Worlds-MAIN/include/okapi/api/chassis/model/hDriveModel.hpp", "C++", -53, 0, 0, -166, -29, -248
"/Users/danieldew/Documents/GitHub/29457A-Worlds/Code/Worlds-MAIN/include/okapi/api/chassis/model/readOnlyChassisModel.hpp", "C++", -10, 0, 0, -15, -4, -29
"/Users/danieldew/Documents/GitHub/29457A-Worlds/Code/Worlds-MAIN/include/okapi/api/chassis/model/skidSteerModel.hpp", "C++", -43, 0, 0, -131, -25, -199
"/Users/danieldew/Documents/GitHub/29457A-Worlds/Code/Worlds-MAIN/include/okapi/api/chassis/model/threeEncoderSkidSteerModel.hpp", "C++", -18, 0, 0, -23, -6, -47
"/Users/danieldew/Documents/GitHub/29457A-Worlds/Code/Worlds-MAIN/include/okapi/api/chassis/model/threeEncoderXDriveModel.hpp", "C++", -20, 0, 0, -25, -6, -51
"/Users/danieldew/Documents/GitHub/29457A-Worlds/Code/Worlds-MAIN/include/okapi/api/chassis/model/xDriveModel.hpp", "C++", -59, 0, 0, -184, -31, -274
"/Users/danieldew/Documents/GitHub/29457A-Worlds/Code/Worlds-MAIN/include/okapi/api/control/async/asyncController.hpp", "C++", -9, 0, 0, -13, -3, -25
"/Users/danieldew/Documents/GitHub/29457A-Worlds/Code/Worlds-MAIN/include/okapi/api/control/async/asyncLinearMotionProfileController.hpp", "C++", -80, 0, 0, -174, -38, -292
"/Users/danieldew/Documents/GitHub/29457A-Worlds/Code/Worlds-MAIN/include/okapi/api/control/async/asyncMotionProfileController.hpp", "C++", -90, 0, 0, -195, -42, -327
"/Users/danieldew/Documents/GitHub/29457A-Worlds/Code/Worlds-MAIN/include/okapi/api/control/async/asyncPosIntegratedController.hpp", "C++", -41, 0, 0, -86, -19, -146
"/Users/danieldew/Documents/GitHub/29457A-Worlds/Code/Worlds-MAIN/include/okapi/api/control/async/asyncPosPidController.hpp", "C++", -43, 0, 0, -49, -9, -101
"/Users/danieldew/Documents/GitHub/29457A-Worlds/Code/Worlds-MAIN/include/okapi/api/control/async/asyncPositionController.hpp", "C++", -11, 0, 0, -14, -4, -29
"/Users/danieldew/Documents/GitHub/29457A-Worlds/Code/Worlds-MAIN/include/okapi/api/control/async/asyncVelIntegratedController.hpp", "C++", -38, 0, 0, -71, -16, -125
"/Users/danieldew/Documents/GitHub/29457A-Worlds/Code/Worlds-MAIN/include/okapi/api/control/async/asyncVelPidController.hpp", "C++", -30, 0, 0, -29, -6, -65
"/Users/danieldew/Documents/GitHub/29457A-Worlds/Code/Worlds-MAIN/include/okapi/api/control/async/asyncVelocityController.hpp", "C++", -7, 0, 0, -5, -3, -15
"/Users/danieldew/Documents/GitHub/29457A-Worlds/Code/Worlds-MAIN/include/okapi/api/control/async/asyncWrapper.hpp", "C++", -144, 0, 0, -112, -32, -288
"/Users/danieldew/Documents/GitHub/29457A-Worlds/Code/Worlds-MAIN/include/okapi/api/control/closedLoopController.hpp", "C++", -19, 0, 0, -56, -12, -87
"/Users/danieldew/Documents/GitHub/29457A-Worlds/Code/Worlds-MAIN/include/okapi/api/control/controllerInput.hpp", "C++", -7, 0, 0, -11, -2, -20
"/Users/danieldew/Documents/GitHub/29457A-Worlds/Code/Worlds-MAIN/include/okapi/api/control/controllerOutput.hpp", "C++", -7, 0, 0, -11, -2, -20
"/Users/danieldew/Documents/GitHub/29457A-Worlds/Code/Worlds-MAIN/include/okapi/api/control/iterative/iterativeController.hpp", "C++", -17, 0, 0, -53, -10, -80
"/Users/danieldew/Documents/GitHub/29457A-Worlds/Code/Worlds-MAIN/include/okapi/api/control/iterative/iterativeMotorVelocityController.hpp", "C++", -34, 0, 0, -95, -22, -151
"/Users/danieldew/Documents/GitHub/29457A-Worlds/Code/Worlds-MAIN/include/okapi/api/control/iterative/iterativePosPidController.hpp", "C++", -83, 0, 0, -156, -38, -277
"/Users/danieldew/Documents/GitHub/29457A-Worlds/Code/Worlds-MAIN/include/okapi/api/control/iterative/iterativePositionController.hpp", "C++", -6, 0, 0, -5, -3, -14
"/Users/danieldew/Documents/GitHub/29457A-Worlds/Code/Worlds-MAIN/include/okapi/api/control/iterative/iterativeVelPidController.hpp", "C++", -77, 0, 0, -147, -32, -256
"/Users/danieldew/Documents/GitHub/29457A-Worlds/Code/Worlds-MAIN/include/okapi/api/control/iterative/iterativeVelocityController.hpp", "C++", -6, 0, 0, -5, -3, -14
"/Users/danieldew/Documents/GitHub/29457A-Worlds/Code/Worlds-MAIN/include/okapi/api/control/offsettableControllerInput.hpp", "C++", -15, 0, 0, -20, -7, -42
"/Users/danieldew/Documents/GitHub/29457A-Worlds/Code/Worlds-MAIN/include/okapi/api/control/util/controllerRunner.hpp", "C++", -75, 0, 0, -41, -16, -132
"/Users/danieldew/Documents/GitHub/29457A-Worlds/Code/Worlds-MAIN/include/okapi/api/control/util/flywheelSimulator.hpp", "C++", -44, 0, 0, -91, -22, -157
"/Users/danieldew/Documents/GitHub/29457A-Worlds/Code/Worlds-MAIN/include/okapi/api/control/util/pathfinderUtil.hpp", "C++", -15, 0, 0, -5, -4, -24
"/Users/danieldew/Documents/GitHub/29457A-Worlds/Code/Worlds-MAIN/include/okapi/api/control/util/pidTuner.hpp", "C++", -65, 0, 0, -5, -11, -81
"/Users/danieldew/Documents/GitHub/29457A-Worlds/Code/Worlds-MAIN/include/okapi/api/control/util/settledUtil.hpp", "C++", -22, 0, 0, -23, -7, -52
"/Users/danieldew/Documents/GitHub/29457A-Worlds/Code/Worlds-MAIN/include/okapi/api/coreProsAPI.hpp", "C++", -110, 0, 0, -5, -17, -132
"/Users/danieldew/Documents/GitHub/29457A-Worlds/Code/Worlds-MAIN/include/okapi/api/device/button/abstractButton.hpp", "C++", -13, 0, 0, -26, -8, -47
"/Users/danieldew/Documents/GitHub/29457A-Worlds/Code/Worlds-MAIN/include/okapi/api/device/button/buttonBase.hpp", "C++", -20, 0, 0, -23, -10, -53
"/Users/danieldew/Documents/GitHub/29457A-Worlds/Code/Worlds-MAIN/include/okapi/api/device/motor/abstractMotor.hpp", "C++", -74, 0, 0, -413, -51, -538
"/Users/danieldew/Documents/GitHub/29457A-Worlds/Code/Worlds-MAIN/include/okapi/api/device/rotarysensor/continuousRotarySensor.hpp", "C++", -8, 0, 0, -10, -3, -21
"/Users/danieldew/Documents/GitHub/29457A-Worlds/Code/Worlds-MAIN/include/okapi/api/device/rotarysensor/rotarySensor.hpp", "C++", -10, 0, 0, -10, -4, -24
"/Users/danieldew/Documents/GitHub/29457A-Worlds/Code/Worlds-MAIN/include/okapi/api/filter/averageFilter.hpp", "C++", -28, 0, 0, -24, -8, -60
"/Users/danieldew/Documents/GitHub/29457A-Worlds/Code/Worlds-MAIN/include/okapi/api/filter/composableFilter.hpp", "C++", -18, 0, 0, -26, -7, -51
"/Users/danieldew/Documents/GitHub/29457A-Worlds/Code/Worlds-MAIN/include/okapi/api/filter/demaFilter.hpp", "C++", -18, 0, 0, -28, -7, -53
"/Users/danieldew/Documents/GitHub/29457A-Worlds/Code/Worlds-MAIN/include/okapi/api/filter/ekfFilter.hpp", "C++", -21, 0, 0, -44, -7, -72
"/Users/danieldew/Documents/GitHub/29457A-Worlds/Code/Worlds-MAIN/include/okapi/api/filter/emaFilter.hpp", "C++", -15, 0, 0, -26, -7, -48
"/Users/danieldew/Documents/GitHub/29457A-Worlds/Code/Worlds-MAIN/include/okapi/api/filter/filter.hpp", "C++", -9, 0, 0, -16, -4, -29
"/Users/danieldew/Documents/GitHub/29457A-Worlds/Code/Worlds-MAIN/include/okapi/api/filter/filteredControllerInput.hpp", "C++", -20, 0, 0, -24, -5, -49
"/Users/danieldew/Documents/GitHub/29457A-Worlds/Code/Worlds-MAIN/include/okapi/api/filter/medianFilter.hpp", "C++", -59, 0, 0, -26, -10, -95
"/Users/danieldew/Documents/GitHub/29457A-Worlds/Code/Worlds-MAIN/include/okapi/api/filter/passthroughFilter.hpp", "C++", -12, 0, 0, -19, -6, -37
"/Users/danieldew/Documents/GitHub/29457A-Worlds/Code/Worlds-MAIN/include/okapi/api/filter/velMath.hpp", "C++", -33, 0, 0, -32, -10, -75
"/Users/danieldew/Documents/GitHub/29457A-Worlds/Code/Worlds-MAIN/include/okapi/api/odometry/odomMath.hpp", "C++", -22, 0, 0, -63, -11, -96
"/Users/danieldew/Documents/GitHub/29457A-Worlds/Code/Worlds-MAIN/include/okapi/api/odometry/odomState.hpp", "C++", -19, 0, 0, -32, -7, -58
"/Users/danieldew/Documents/GitHub/29457A-Worlds/Code/Worlds-MAIN/include/okapi/api/odometry/odometry.hpp", "C++", -19, 0, 0, -33, -10, -62
"/Users/danieldew/Documents/GitHub/29457A-Worlds/Code/Worlds-MAIN/include/okapi/api/odometry/point.hpp", "C++", -16, 0, 0, -11, -4, -31
"/Users/danieldew/Documents/GitHub/29457A-Worlds/Code/Worlds-MAIN/include/okapi/api/odometry/stateMode.hpp", "C++", -7, 0, 0, -8, -3, -18
"/Users/danieldew/Documents/GitHub/29457A-Worlds/Code/Worlds-MAIN/include/okapi/api/odometry/threeEncoderOdometry.hpp", "C++", -17, 0, 0, -23, -4, -44
"/Users/danieldew/Documents/GitHub/29457A-Worlds/Code/Worlds-MAIN/include/okapi/api/odometry/twoEncoderOdometry.hpp", "C++", -37, 0, 0, -45, -12, -94
"/Users/danieldew/Documents/GitHub/29457A-Worlds/Code/Worlds-MAIN/include/okapi/api/units/QAcceleration.hpp", "C++", -23, 0, 0, -9, -5, -37
"/Users/danieldew/Documents/GitHub/29457A-Worlds/Code/Worlds-MAIN/include/okapi/api/units/QAngle.hpp", "C++", -22, 0, 0, -9, -5, -36
"/Users/danieldew/Documents/GitHub/29457A-Worlds/Code/Worlds-MAIN/include/okapi/api/units/QAngularAcceleration.hpp", "C++", -5, 0, 0, -9, -3, -17
"/Users/danieldew/Documents/GitHub/29457A-Worlds/Code/Worlds-MAIN/include/okapi/api/units/QAngularJerk.hpp", "C++", -5, 0, 0, -9, -3, -17
"/Users/danieldew/Documents/GitHub/29457A-Worlds/Code/Worlds-MAIN/include/okapi/api/units/QAngularSpeed.hpp", "C++", -25, 0, 0, -9, -6, -40
"/Users/danieldew/Documents/GitHub/29457A-Worlds/Code/Worlds-MAIN/include/okapi/api/units/QArea.hpp", "C++", -14, 0, 0, -9, -4, -27
"/Users/danieldew/Documents/GitHub/29457A-Worlds/Code/Worlds-MAIN/include/okapi/api/units/QForce.hpp", "C++", -30, 0, 0, -9, -5, -44
"/Users/danieldew/Documents/GitHub/29457A-Worlds/Code/Worlds-MAIN/include/okapi/api/units/QFrequency.hpp", "C++", -14, 0, 0, -9, -5, -28
"/Users/danieldew/Documents/GitHub/29457A-Worlds/Code/Worlds-MAIN/include/okapi/api/units/QJerk.hpp", "C++", -7, 0, 0, -9, -3, -19
"/Users/danieldew/Documents/GitHub/29457A-Worlds/Code/Worlds-MAIN/include/okapi/api/units/QLength.hpp", "C++", -71, 0, 0, -9, -5, -85
"/Users/danieldew/Documents/GitHub/29457A-Worlds/Code/Worlds-MAIN/include/okapi/api/units/QMass.hpp", "C++", -49, 0, 0, -9, -5, -63
"/Users/danieldew/Documents/GitHub/29457A-Worlds/Code/Worlds-MAIN/include/okapi/api/units/QPressure.hpp", "C++", -31, 0, 0, -9, -5, -45
"/Users/danieldew/Documents/GitHub/29457A-Worlds/Code/Worlds-MAIN/include/okapi/api/units/QSpeed.hpp", "C++", -30, 0, 0, -9, -5, -44
"/Users/danieldew/Documents/GitHub/29457A-Worlds/Code/Worlds-MAIN/include/okapi/api/units/QTime.hpp", "C++", -42, 0, 0, -9, -5, -56
"/Users/danieldew/Documents/GitHub/29457A-Worlds/Code/Worlds-MAIN/include/okapi/api/units/QTorque.hpp", "C++", -30, 0, 0, -9, -5, -44
"/Users/danieldew/Documents/GitHub/29457A-Worlds/Code/Worlds-MAIN/include/okapi/api/units/QVolume.hpp", "C++", -16, 0, 0, -9, -4, -29
"/Users/danieldew/Documents/GitHub/29457A-Worlds/Code/Worlds-MAIN/include/okapi/api/units/RQuantity.hpp", "C++", -345, 0, 0, -24, -51, -420
"/Users/danieldew/Documents/GitHub/29457A-Worlds/Code/Worlds-MAIN/include/okapi/api/units/RQuantityName.hpp", "C++", -34, 0, 0, -8, -5, -47
"/Users/danieldew/Documents/GitHub/29457A-Worlds/Code/Worlds-MAIN/include/okapi/api/util/abstractRate.hpp", "C++", -13, 0, 0, -23, -6, -42
"/Users/danieldew/Documents/GitHub/29457A-Worlds/Code/Worlds-MAIN/include/okapi/api/util/abstractTimer.hpp", "C++", -29, 0, 0, -79, -18, -126
"/Users/danieldew/Documents/GitHub/29457A-Worlds/Code/Worlds-MAIN/include/okapi/api/util/logging.hpp", "C++", -127, 0, 0, -37, -29, -193
"/Users/danieldew/Documents/GitHub/29457A-Worlds/Code/Worlds-MAIN/include/okapi/api/util/mathUtil.hpp", "C++", -84, 0, 0, -139, -33, -256
"/Users/danieldew/Documents/GitHub/29457A-Worlds/Code/Worlds-MAIN/include/okapi/api/util/supplier.hpp", "C++", -15, 0, 0, -14, -6, -35
"/Users/danieldew/Documents/GitHub/29457A-Worlds/Code/Worlds-MAIN/include/okapi/api/util/timeUtil.hpp", "C++", -23, 0, 0, -9, -10, -42
"/Users/danieldew/Documents/GitHub/29457A-Worlds/Code/Worlds-MAIN/include/okapi/impl/chassis/controller/chassisControllerBuilder.hpp", "C++", -160, 0, 0, -293, -54, -507
"/Users/danieldew/Documents/GitHub/29457A-Worlds/Code/Worlds-MAIN/include/okapi/impl/control/async/asyncMotionProfileControllerBuilder.hpp", "C++", -52, 0, 0, -105, -21, -178
"/Users/danieldew/Documents/GitHub/29457A-Worlds/Code/Worlds-MAIN/include/okapi/impl/control/async/asyncPosControllerBuilder.hpp", "C++", -50, 0, 0, -114, -27, -191
"/Users/danieldew/Documents/GitHub/29457A-Worlds/Code/Worlds-MAIN/include/okapi/impl/control/async/asyncVelControllerBuilder.hpp", "C++", -53, 0, 0, -121, -30, -204
"/Users/danieldew/Documents/GitHub/29457A-Worlds/Code/Worlds-MAIN/include/okapi/impl/control/iterative/iterativeControllerFactory.hpp", "C++", -52, 0, 0, -61, -8, -121
"/Users/danieldew/Documents/GitHub/29457A-Worlds/Code/Worlds-MAIN/include/okapi/impl/control/util/controllerRunnerFactory.hpp", "C++", -12, 0, 0, -11, -3, -26
"/Users/danieldew/Documents/GitHub/29457A-Worlds/Code/Worlds-MAIN/include/okapi/impl/control/util/pidTunerFactory.hpp", "C++", -39, 0, 0, -5, -4, -48
"/Users/danieldew/Documents/GitHub/29457A-Worlds/Code/Worlds-MAIN/include/okapi/impl/device/adiUltrasonic.hpp", "C++", -21, 0, 0, -43, -8, -72
"/Users/danieldew/Documents/GitHub/29457A-Worlds/Code/Worlds-MAIN/include/okapi/impl/device/button/adiButton.hpp", "C++", -14, 0, 0, -31, -6, -51
"/Users/danieldew/Documents/GitHub/29457A-Worlds/Code/Worlds-MAIN/include/okapi/impl/device/button/controllerButton.hpp", "C++", -15, 0, 0, -18, -6, -39
"/Users/danieldew/Documents/GitHub/29457A-Worlds/Code/Worlds-MAIN/include/okapi/impl/device/controller.hpp", "C++", -26, 0, 0, -78, -15, -119
"/Users/danieldew/Documents/GitHub/29457A-Worlds/Code/Worlds-MAIN/include/okapi/impl/device/controllerUtil.hpp", "C++", -34, 0, 0, -23, -8, -65
"/Users/danieldew/Documents/GitHub/29457A-Worlds/Code/Worlds-MAIN/include/okapi/impl/device/distanceSensor.hpp", "C++", -21, 0, 0, -46, -10, -77
"/Users/danieldew/Documents/GitHub/29457A-Worlds/Code/Worlds-MAIN/include/okapi/impl/device/motor/adiMotor.hpp", "C++", -21, 0, 0, -42, -7, -70
"/Users/danieldew/Documents/GitHub/29457A-Worlds/Code/Worlds-MAIN/include/okapi/impl/device/motor/motor.hpp", "C++", -74, 0, 0, -334, -50, -458
"/Users/danieldew/Documents/GitHub/29457A-Worlds/Code/Worlds-MAIN/include/okapi/impl/device/motor/motorGroup.hpp", "C++", -55, 0, 0, -300, -46, -401
"/Users/danieldew/Documents/GitHub/29457A-Worlds/Code/Worlds-MAIN/include/okapi/impl/device/opticalSensor.hpp", "C++", -36, 0, 0, -87, -18, -141
"/Users/danieldew/Documents/GitHub/29457A-Worlds/Code/Worlds-MAIN/include/okapi/impl/device/rotarysensor/IMU.hpp", "C++", -28, 0, 0, -68, -14, -110
"/Users/danieldew/Documents/GitHub/29457A-Worlds/Code/Worlds-MAIN/include/okapi/impl/device/rotarysensor/adiEncoder.hpp", "C++", -15, 0, 0, -51, -8, -74
"/Users/danieldew/Documents/GitHub/29457A-Worlds/Code/Worlds-MAIN/include/okapi/impl/device/rotarysensor/adiGyro.hpp", "C++", -17, 0, 0, -57, -9, -83
"/Users/danieldew/Documents/GitHub/29457A-Worlds/Code/Worlds-MAIN/include/okapi/impl/device/rotarysensor/integratedEncoder.hpp", "C++", -17, 0, 0, -32, -8, -57
"/Users/danieldew/Documents/GitHub/29457A-Worlds/Code/Worlds-MAIN/include/okapi/impl/device/rotarysensor/potentiometer.hpp", "C++", -15, 0, 0, -36, -7, -58
"/Users/danieldew/Documents/GitHub/29457A-Worlds/Code/Worlds-MAIN/include/okapi/impl/device/rotarysensor/rotationSensor.hpp", "C++", -16, 0, 0, -41, -8, -65
"/Users/danieldew/Documents/GitHub/29457A-Worlds/Code/Worlds-MAIN/include/okapi/impl/filter/velMathFactory.hpp", "C++", -24, 0, 0, -39, -6, -69
"/Users/danieldew/Documents/GitHub/29457A-Worlds/Code/Worlds-MAIN/include/okapi/impl/util/configurableTimeUtilFactory.hpp", "C++", -15, 0, 0, -15, -5, -35
"/Users/danieldew/Documents/GitHub/29457A-Worlds/Code/Worlds-MAIN/include/okapi/impl/util/rate.hpp", "C++", -13, 0, 0, -23, -7, -43
"/Users/danieldew/Documents/GitHub/29457A-Worlds/Code/Worlds-MAIN/include/okapi/impl/util/timeUtilFactory.hpp", "C++", -13, 0, 0, -14, -6, -33
"/Users/danieldew/Documents/GitHub/29457A-Worlds/Code/Worlds-MAIN/include/okapi/impl/util/timer.hpp", "C++", -9, 0, 0, -10, -4, -23
"/Users/danieldew/Documents/GitHub/29457A-Worlds/Code/Worlds-MAIN/include/okapi/squiggles/constraints.hpp", "C++", -35, 0, 0, -26, -5, -66
"/Users/danieldew/Documents/GitHub/29457A-Worlds/Code/Worlds-MAIN/include/okapi/squiggles/geometry/controlvector.hpp", "C++", -34, 0, 0, -19, -9, -62
"/Users/danieldew/Documents/GitHub/29457A-Worlds/Code/Worlds-MAIN/include/okapi/squiggles/geometry/pose.hpp", "C++", -32, 0, 0, -25, -10, -67
"/Users/danieldew/Documents/GitHub/29457A-Worlds/Code/Worlds-MAIN/include/okapi/squiggles/geometry/profilepoint.hpp", "C++", -67, 0, 0, -23, -10, -100
"/Users/danieldew/Documents/GitHub/29457A-Worlds/Code/Worlds-MAIN/include/okapi/squiggles/io.hpp", "C++", -12, 0, 0, -38, -7, -57
"/Users/danieldew/Documents/GitHub/29457A-Worlds/Code/Worlds-MAIN/include/okapi/squiggles/math/quinticpolynomial.hpp", "C++", -28, 0, 0, -31, -6, -65
"/Users/danieldew/Documents/GitHub/29457A-Worlds/Code/Worlds-MAIN/include/okapi/squiggles/math/utils.hpp", "C++", -43, 0, 0, -14, -4, -61
"/Users/danieldew/Documents/GitHub/29457A-Worlds/Code/Worlds-MAIN/include/okapi/squiggles/physicalmodel/passthroughmodel.hpp", "C++", -23, 0, 0, -9, -7, -39
"/Users/danieldew/Documents/GitHub/29457A-Worlds/Code/Worlds-MAIN/include/okapi/squiggles/physicalmodel/physicalmodel.hpp", "C++", -15, 0, 0, -23, -6, -44
"/Users/danieldew/Documents/GitHub/29457A-Worlds/Code/Worlds-MAIN/include/okapi/squiggles/physicalmodel/tankmodel.hpp", "C++", -23, 0, 0, -13, -9, -45
"/Users/danieldew/Documents/GitHub/29457A-Worlds/Code/Worlds-MAIN/include/okapi/squiggles/spline.hpp", "C++", -138, 0, 0, -136, -37, -311
"/Users/danieldew/Documents/GitHub/29457A-Worlds/Code/Worlds-MAIN/include/okapi/squiggles/squiggles.hpp", "C++", -12, 0, 0, -6, -4, -22
"/Users/danieldew/Documents/GitHub/29457A-Worlds/Code/Worlds-MAIN/include/pros/adi.h", "C++", -142, 0, 0, -671, -63, -876
"/Users/danieldew/Documents/GitHub/29457A-Worlds/Code/Worlds-MAIN/include/pros/adi.hpp", "C++", -110, 0, 0, -720, -68, -898
"/Users/danieldew/Documents/GitHub/29457A-Worlds/Code/Worlds-MAIN/include/pros/api_legacy.h", "C++", -62, 0, 0, -34, -13, -109
"/Users/danieldew/Documents/GitHub/29457A-Worlds/Code/Worlds-MAIN/include/pros/apix.h", "C++", -72, 0, 0, -475, -47, -594
"/Users/danieldew/Documents/GitHub/29457A-Worlds/Code/Worlds-MAIN/include/pros/colors.h", "C++", -153, 0, 0, -14, -5, -172
"/Users/danieldew/Documents/GitHub/29457A-Worlds/Code/Worlds-MAIN/include/pros/colors.hpp", "C++", -153, 0, 0, -14, -4, -171
"/Users/danieldew/Documents/GitHub/29457A-Worlds/Code/Worlds-MAIN/include/pros/distance.h", "C++", -19, 0, 0, -73, -10, -102
"/Users/danieldew/Documents/GitHub/29457A-Worlds/Code/Worlds-MAIN/include/pros/distance.hpp", "C++", -18, 0, 0, -85, -12, -115
"/Users/danieldew/Documents/GitHub/29457A-Worlds/Code/Worlds-MAIN/include/pros/error.h", "C++", -9, 0, 0, -16, -5, -30
"/Users/danieldew/Documents/GitHub/29457A-Worlds/Code/Worlds-MAIN/include/pros/ext_adi.h", "C++", -61, 0, 0, -685, -48, -794
"/Users/danieldew/Documents/GitHub/29457A-Worlds/Code/Worlds-MAIN/include/pros/gps.h", "C++", -44, 0, 0, -247, -23, -314
"/Users/danieldew/Documents/GitHub/29457A-Worlds/Code/Worlds-MAIN/include/pros/gps.hpp", "C++", -39, 0, 0, -219, -27, -285
"/Users/danieldew/Documents/GitHub/29457A-Worlds/Code/Worlds-MAIN/include/pros/imu.h", "C++", -73, 0, 0, -433, -40, -546
"/Users/danieldew/Documents/GitHub/29457A-Worlds/Code/Worlds-MAIN/include/pros/imu.hpp", "C++", -39, 0, 0, -413, -8, -460
"/Users/danieldew/Documents/GitHub/29457A-Worlds/Code/Worlds-MAIN/include/pros/link.h", "C++", -47, 0, 0, -209, -20, -276
"/Users/danieldew/Documents/GitHub/29457A-Worlds/Code/Worlds-MAIN/include/pros/link.hpp", "C++", -22, 0, 0, -165, -14, -201
"/Users/danieldew/Documents/GitHub/29457A-Worlds/Code/Worlds-MAIN/include/pros/llemu.h", "C++", -48, 0, 0, -185, -23, -256
"/Users/danieldew/Documents/GitHub/29457A-Worlds/Code/Worlds-MAIN/include/pros/llemu.hpp", "C++", -41, 0, 0, -199, -23, -263
"/Users/danieldew/Documents/GitHub/29457A-Worlds/Code/Worlds-MAIN/include/pros/misc.h", "C++", -141, 0, 0, -309, -34, -484
"/Users/danieldew/Documents/GitHub/29457A-Worlds/Code/Worlds-MAIN/include/pros/misc.hpp", "C++", -54, 0, 0, -253, -25, -332
"/Users/danieldew/Documents/GitHub/29457A-Worlds/Code/Worlds-MAIN/include/pros/motors.h", "C++", -205, 0, 0, -864, -72, -1141
"/Users/danieldew/Documents/GitHub/29457A-Worlds/Code/Worlds-MAIN/include/pros/motors.hpp", "C++", -141, 0, 0, -1247, -97, -1485
"/Users/danieldew/Documents/GitHub/29457A-Worlds/Code/Worlds-MAIN/include/pros/optical.h", "C++", -63, 0, 0, -219, -26, -308
"/Users/danieldew/Documents/GitHub/29457A-Worlds/Code/Worlds-MAIN/include/pros/optical.hpp", "C++", -30, 0, 0, -213, -24, -267
"/Users/danieldew/Documents/GitHub/29457A-Worlds/Code/Worlds-MAIN/include/pros/rotation.h", "C++", -27, 0, 0, -179, -18, -224
"/Users/danieldew/Documents/GitHub/29457A-Worlds/Code/Worlds-MAIN/include/pros/rotation.hpp", "C++", -23, 0, 0, -151, -17, -191
"/Users/danieldew/Documents/GitHub/29457A-Worlds/Code/Worlds-MAIN/include/pros/rtos.h", "C++", -100, 0, 0, -298, -45, -443
"/Users/danieldew/Documents/GitHub/29457A-Worlds/Code/Worlds-MAIN/include/pros/rtos.hpp", "C++", -149, 0, 0, -451, -59, -659
"/Users/danieldew/Documents/GitHub/29457A-Worlds/Code/Worlds-MAIN/include/pros/screen.h", "C++", -88, 0, 0, -372, -40, -500
"/Users/danieldew/Documents/GitHub/29457A-Worlds/Code/Worlds-MAIN/include/pros/screen.hpp", "C++", -50, 0, 0, -302, -34, -386
"/Users/danieldew/Documents/GitHub/29457A-Worlds/Code/Worlds-MAIN/include/pros/serial.h", "C++", -25, 0, 0, -206, -16, -247
"/Users/danieldew/Documents/GitHub/29457A-Worlds/Code/Worlds-MAIN/include/pros/serial.hpp", "C++", -27, 0, 0, -184, -18, -229
"/Users/danieldew/Documents/GitHub/29457A-Worlds/Code/Worlds-MAIN/include/pros/vision.h", "C++", -95, 0, 0, -428, -35, -558
"/Users/danieldew/Documents/GitHub/29457A-Worlds/Code/Worlds-MAIN/include/pros/vision.hpp", "C++", -44, 0, 0, -374, -28, -446
"/Users/danieldew/Documents/GitHub/29457A-Worlds/Code/Worlds-MAIN/include/usr/Inputs.h", "C++", -49, 0, 0, -38, -3, -90
"/Users/danieldew/Documents/GitHub/29457A-Worlds/Code/Worlds-MAIN/include/usr/fieldDimensions.h", "C++", -20, 0, 0, -18, -5, -43
"/Users/danieldew/Documents/GitHub/29457A-Worlds/Code/Worlds-MAIN/include/usr/robot.h", "C++", -97, 0, 0, -103, -12, -212
"/Users/danieldew/Documents/GitHub/29457A-Worlds/Code/Worlds-MAIN/include/usr/utils.h", "C++", -26, 0, 0, -28, -10, -64
"/Users/danieldew/Documents/GitHub/29457A-Worlds/Code/Worlds-MAIN/src/Inputs.cpp", "C++", 71, 0, 0, 2, 10, 83
"/Users/danieldew/Documents/GitHub/29457A-Worlds/Code/Worlds-MAIN/src/autonomous.cpp", "C++", 47, 0, 0, 9, 9, 65
"/Users/danieldew/Documents/GitHub/29457A-Worlds/Code/Worlds-MAIN/src/main.cpp", "C++", 32, 0, 0, 60, 10, 102
"/Users/danieldew/Documents/GitHub/29457A-Worlds/Code/Worlds-MAIN/src/opcontrol.cpp", "C++", 99, 0, 0, 21, 19, 139
"/Users/danieldew/Documents/GitHub/29457A-Worlds/Code/Worlds-MAIN/src/robotConfig/dimensions.cpp", "C++", 7, 0, 0, 0, 1, 8
"/Users/danieldew/Documents/GitHub/29457A-Worlds/Code/Worlds-MAIN/src/robotConfig/motors.cpp", "C++", 20, 0, 0, 3, 7, 30
"/Users/danieldew/Documents/GitHub/29457A-Worlds/Code/Worlds-MAIN/src/robotConfig/pistons.cpp", "C++", 5, 0, 0, 0, 1, 6
"/Users/danieldew/Documents/GitHub/29457A-Worlds/Code/Worlds-MAIN/src/robotConfig/robot.cpp", "C++", 8, 0, 0, 1, 2, 11
"/Users/danieldew/Documents/GitHub/29457A-Worlds/Code/Worlds-MAIN/src/robotConfig/sensors.cpp", "C++", 10, 0, 0, 0, 2, 12
"/Users/danieldew/Documents/GitHub/29457A-Worlds/Code/Worlds-MAIN/src/robotConfig/tunables.cpp", "C++", 24, 0, 0, 3, 1, 28
"/Users/danieldew/Documents/GitHub/29457A-Worlds/Code/Worlds-MAIN/src/subsystems/BalanceMech.cpp", "C++", 10, 0, 0, 0, 4, 14
"/Users/danieldew/Documents/GitHub/29457A-Worlds/Code/Worlds-MAIN/src/subsystems/Intake.cpp", "C++", 55, 0, 0, 18, 5, 78
"/Users/danieldew/Documents/GitHub/29457A-Worlds/Code/Worlds-MAIN/src/subsystems/catapult.cpp", "C++", 46, 0, 0, 10, 5, 61
"/Users/danieldew/Documents/GitHub/29457A-Worlds/Code/Worlds-MAIN/src/subsystems/wings.cpp", "C++", 26, 0, 0, 5, 3, 34
"/Users/danieldew/Documents/GitHub/29457A-Worlds/Code/Worlds-MAIN/src/utils.cpp", "C++", 63, 0, 0, 4, 4, 71
"Total", "-", -19025, -112, -58, -26500, -6375, -52070