"filename", "language", "C++", "comment", "blank", "total"
"/Users/danieldew/Documents/GitHub/29457A-Worlds/Code/Worlds-MAIN/src/Inputs.cpp", "C++", 71, 2, 10, 83
"/Users/danieldew/Documents/GitHub/29457A-Worlds/Code/Worlds-MAIN/src/autonomous.cpp", "C++", 47, 9, 9, 65
"/Users/danieldew/Documents/GitHub/29457A-Worlds/Code/Worlds-MAIN/src/main.cpp", "C++", 32, 60, 10, 102
"/Users/danieldew/Documents/GitHub/29457A-Worlds/Code/Worlds-MAIN/src/opcontrol.cpp", "C++", 99, 21, 19, 139
"/Users/danieldew/Documents/GitHub/29457A-Worlds/Code/Worlds-MAIN/src/robotConfig/dimensions.cpp", "C++", 7, 0, 1, 8
"/Users/danieldew/Documents/GitHub/29457A-Worlds/Code/Worlds-MAIN/src/robotConfig/motors.cpp", "C++", 20, 3, 7, 30
"/Users/danieldew/Documents/GitHub/29457A-Worlds/Code/Worlds-MAIN/src/robotConfig/pistons.cpp", "C++", 5, 0, 1, 6
"/Users/danieldew/Documents/GitHub/29457A-Worlds/Code/Worlds-MAIN/src/robotConfig/robot.cpp", "C++", 8, 1, 2, 11
"/Users/danieldew/Documents/GitHub/29457A-Worlds/Code/Worlds-MAIN/src/robotConfig/sensors.cpp", "C++", 10, 0, 2, 12
"/Users/danieldew/Documents/GitHub/29457A-Worlds/Code/Worlds-MAIN/src/robotConfig/tunables.cpp", "C++", 24, 3, 1, 28
"/Users/danieldew/Documents/GitHub/29457A-Worlds/Code/Worlds-MAIN/src/subsystems/BalanceMech.cpp", "C++", 10, 0, 4, 14
"/Users/danieldew/Documents/GitHub/29457A-Worlds/Code/Worlds-MAIN/src/subsystems/Intake.cpp", "C++", 55, 18, 5, 78
"/Users/danieldew/Documents/GitHub/29457A-Worlds/Code/Worlds-MAIN/src/subsystems/catapult.cpp", "C++", 46, 10, 5, 61
"/Users/danieldew/Documents/GitHub/29457A-Worlds/Code/Worlds-MAIN/src/subsystems/wings.cpp", "C++", 26, 5, 3, 34
"/Users/danieldew/Documents/GitHub/29457A-Worlds/Code/Worlds-MAIN/src/utils.cpp", "C++", 63, 4, 4, 71
"Total", "-", 523, 136, 83, 742